30 31 30 31 30 31 30 31 30 31 30 31 30 31 30 31 30 31 30 31 30 31 
36 37 36 37 36 37 36 37 36 37 36 37 36 37 36 37 36 37 36 37 36 37    
34 35 34 35 19 40 41 41 41 41 41 42 34 35 34 35 34 35 34 35 34 35
16 17 17 17 20 43 39 39 39 39 39 44 24 23 23 23 23 23 23 23 23 22
30 31 30 31 20 43 39 39 39 39 39 44 25 52 52 52 52 52 52 52 52 29
36 37 36 37 20 43 39 39 39 39 39 44 25 29 27 27 27 27 27 27 27 28
30 31 30 35 20 43 39 39 39 39 39 47 25 29 32 33 32 33 32 33 32 33
36 37 36 37 20 45 46 46 46 46 46 46 25 29 36 37 36 37 36 37 36 37 
34 35 34 35 14 17 17 17 17 17 17 17 28 26 30 31 30 31 30 31 30 31
41 41 41 41 41 41 41 41 41 41 41 42 22 25 36 37 36 37 36 37 36 37
39 39 39 39 39 39 39 39 39 39 39 44 25 29 30 31 30 31 30 31 30 31
39 39 39 39 39 39 39 39 39 39 39 44 25 29 36 37 36 37 36 37 36 37
39 39 39 39 39 39 39 39 39 39 39 44 25 29 30 31 30 31 30 31 30 31
39 39 39 39 39 39 39 39 39 39 39 44 25 29 36 37 36 37 36 37 36 37
39 39 39 39 39 39 39 39 39 39 39 44 25 29 30 31 30 31 30 31 30 31
39 39 39 39 39 39 39 39 39 39 39 44 25 29 36 37 36 37 36 37 36 37
39 39 39 39 39 39 39 39 39 39 39 44 25 29 30 31 30 31 30 31 30 31
39 39 39 39 39 39 39 39 39 39 39 44 25 29 36 37 36 37 36 37 36 37
39 39 39 39 39 39 39 39 39 39 39 44 25 29 30 31 30 31 30 31 30 31
46 46 46 46 46 46 46 46 46 46 46 47 25 29 34 35 34 35 34 35 34 35